pyX..hVYH
oXpXXvhp.
YpXH..pvy
.p.o..Xhd
y.V.O.H.X
XH.OXXd..
dX..O...D
X.p...DY.
YOoy.VX.d
