__.vXoV__
_..X.XhX_
..H_V_..h
Xv_X.X_Ov
O...O..H.
Xv_o.X_O.
.X._._.oX
_..XOX.X_
__.O.O.__
