___XXX_______
__X.PPX______
_.._..X._____
X.OX_X_.X____
.P.X..._X.___
X_X_p..._oO__
_o_._XOp._.._
__X.X_X...XPX
___.O._.p_X..
____X.X_X._..
_____._...OX_
______._P..__
_______XXX___
