___..____
__....___
_......__
..p....X_
..XXp.X.X
_.X.X..P.
__..pX.X_
___....__
____..___
