__yy______
_..Y._____
XhX..n____
.vv__vy___
_..___nH__
__..___y._
___Yh_yn..
____vn..H_
_____NY.__
______X___
