____X______
____.X_____
____XhX____
____..X.___
XV..X.XXX__
_.X.Xn..vX_
__.XnXX.X.X
___.X..____
____X..____
_____.H____
______X____
