____.d________
___._nh_______
Xdy_Yy.O._____
__vP_Xp_Y.____
_yp.____.vX___
__NX_O._y.p___
____.XvY_n____
____Y.n__DhHo_
_____y_vP__._v
_______yhY_py.
________ph..__
__________.___
